###############
#____#_#4#____#
##_#___#___####
##__#______#_##
#____#_3_#____#
#_#########_#_#
#____###=#____#
#_##_##_##_##_#
#______+______#
###############