########
#______#
#_###_##
#__+#__#
########