####_####_####_#___#
#____#__#_#__#_##__#
####_#__#_#__#_#_#_#
___#_#__#_#__#_#__##
####_####_####_#___#