###############
#____#_#2#____#
#_##___#___##_#
#_##_#_#_#_##_#
#____#_1_#____#
#_###########_#
#____###=#____#
#_##_#####_##_#
#______+______#
###############